000000000000000000000000000000000000000000000000000000000000000000000
000000000000000000000000000000000000000000000000000000000000000000000
000000000000000000000000000000000000000000000000000000000000000000000
000000000000000000000000000000000000000000000000000000000000000000000
000000000000000000000000000000000000000000000000000111110000000000000
000000000000000000000000000111111111000000000000001111110000000000000
000000000000000000000000001111111111100000000000011011011000000000000
000000000000000000000000001110111011100000000000011111111000000000000
000000000000000000000000001111111111100000000000001100110000000000000
000000000000000000000000001111111111100000000000000011100000000000000
000000000000000000000000000111000110000000000000000000000000000000000
000000000000000000000000000001111100000000000000000000000000000000000
000000000000000000000000000000111000000000000000000000000000000000000
000000000000010000000000000000000000000000000100000000000000000000000
000000000000010000000000000000000000000000000100000000000000000000000
000000000000010000000000000000000000000000000100000000000000000000000
000000000000010000000000000000000000000000000100000000000000000000000
000000000011111110000000000000000000000000011111000000000000000000000
000000000000010000000000000000000000000000000100000000000000000000000
000000000000000000000000000000000000000000000000000000000000000000000
000000000000000000000000000000000000000000000000000000000000000000000
000000000000000000000000000000000000000000000000000000000000000000000
000000000000000000000000000000000000000000000000000000000000000000000
000000000000000000000000000000000000000000000000000000000000000000000
