000000000000000000000000000000000000000000000000000000000000000000000
000000000000000000000000000000000000000000000000000000000000000000000
000000000000000000000000000000000000000000000000000000000000000000000
000000000000000000000000000000000000000000000000000000000000000000000
000000111100000000000000000000000000000000000000000000000000000000000
000000111100000000000000000000000000000000000000000000000000000000000
000000111100000000000000000000000000000000000000000000000000000000000
000000111100000000000000000000000000000000000000000000000000000000000
000000111100000000000000000000000000000000000000000000011110000000000
000000111100000000000000000000111000000000000000000000011110000000000
000000111100000000000000000001111100000000000000000000011110000000000
000000111100000000000000000001111100000000000000000000011110000000000
000000111100000000000000000000111000000000000000000000011110000000000
000000111100000000000000000000000000000000000000000000011110000000000
000000111100000000000000000000000000000000000000000000011110000000000
000000000000000000000000000000000000000000000000000000011110000000000
000000000000000000000000000000000000000000000000000000011110000000000
000000000000000000000000000000000000000000000000000000011110000000000
000000000000000000000000000000000000000000000000000000011110000000000
000000000000000000000000000000000000000000000000000000000000000000000
000000000000000000000000000000000000000000000000000000000000000000000
000000000000000000000000000000000000000000000000000000000000000000000
000000000000000000000000000000000000000000000000000000000000000000000
000000000000000000000000000000000000000000000000000000000000000000000
